###########
#   #     #
### # ### #
#   #   ###
# ##### # #
#   #D  # #
# ### ### #
#   #     #
# # #### ##
# #      ##
###########
