################
#              #
#              #
#  P           #
#              #
#              #
#              #
#              #
#              #
#              #
#              #
#              #
#              #
#              #
#             D#
################
