###########
#   #D#   #
#   # #   #
#         #
#   # # # #
#    P  # #
#   # # # #
###       #
#     #   #
#  #  ##  #
###########
