#########
#   D   #
#  ###  #
#  #P#  #
#       #
#########
