##########
#P       #
######## #
#D       #
##########
