##########
#P      ##
####### ##
######  ##
#D     ###
##########
