##########
#     ####
#  P  #D #
#        #
###      #
#       ##
#        #
##       #
#    #   #
##########
