##########
#P  ##  D#
#   ##   #
#   ##   #
#        #
#        #
##########
