#######
#P  #D#
#   # #
#   # #
#     #
#     #
#     #
#######
