##########
#        #
#   #    #
#   #    #
#        #
#        #
#        #
#        #
#        #
##########
