##########
#P      D#
#   #    #
#   #    #
#        #
#        #
#        #
#        #
#        #
##########
